#################
    # # # #
    # # # ##################
    # # # # #
    # # # # #
    # ####### # ########## #
    ### # # # #
    #################### # #
    ##### # #
    # # #
    # # # #
    # # # #
    # # # #
    # # #
    ################ ###############
    # #######
    #
    ##########$ 